R   500         600

NO textures/wood.xpm      

SO textures/greystone.xpm


S textures/barrel.xpm    
   

WE textures/mossy.xpm 


EA    textures/purplestone.xpm

F      55,240,1

C       1,40,50


11111111111111111
12000000000000001       
1220100020N000001111111111111111111111111111111111111
12201000100022000000000000000000000000000000000000001 
11111111111111111111111111111111111111111111111111111
 11111     

  
  








