1111111111111111
1000000000000001
100000000C000001
1000000001000001
10000C0011000001
1000000000000001
1000000000000001
10000C0000C00001
1000C00C00000001
10E0000000000C01
1000000000P00001
1111111111111111
